run_time       ,total_data     ,mutihop        ,sensor_data_origin,sensor_data_calc,sensor_data    ,uav_data_calc  ,uav_data_origin,uav_data       ,lost_data      ,connect_num    ,buffer_overflow_num
100,0,0,0,0,0,0,0,0,0,160,0
200,237150,0,235875,0,235875,0,1275,1275,0,168,0
300,474300,39100,365500,67150,432650,0,2550,2550,0,168,0
400,711450,181900,263075,262650,525725,0,3825,3825,0,168,0
500,948600,221000,392700,254150,646850,0,5100,5100,75650,168,0
600,1185750,363800,290764,449650,740414,0,5100,5100,76436,168,1
700,1422900,402900,417903,277100,695003,850,6800,7650,317347,168,1
800,1660050,545700,316328,295800,612128,850,8075,8925,493297,168,0
900,1897200,584800,446803,231200,678003,850,9350,10200,624197,168,0
1000,2134350,727600,344463,405450,749913,850,10625,11475,645362,168,1
1100,2371500,766700,474938,233750,708688,850,11900,12750,883362,168,0
1200,2608650,909500,372513,429250,801763,850,13175,14025,883362,168,0
1300,2845800,948600,501798,420750,922548,850,14450,15300,959352,168,1
1400,3082950,1091400,392913,616250,1009163,850,15725,16575,965812,168,2
1500,3320100,1130500,523537,233750,757287,850,17000,17850,1414463,168,1
1600,3557250,1273300,420687,408000,828687,850,18275,19125,1436138,168,1
1700,3794400,1312400,550057,343400,893457,850,19550,20400,1568143,168,1
1800,4031550,1455200,446357,517650,964007,850,20825,21675,1590668,168,2
1900,4268700,1494300,577852,289850,867702,850,20825,21675,1885023,168,1
2000,4505850,1637100,464487,464100,928587,1700,22525,24225,1915938,168,16
2100,4743000,1676200,581107,399500,980607,1700,23800,25500,2060693,168,16
2200,4980150,1819000,463807,595000,1058807,1700,25075,26775,2075568,168,17
2300,5217300,1858100,580427,423300,1003727,1700,26350,28050,2327423,168,16
2400,5454450,2000900,463637,618800,1082437,1700,27625,29325,2341788,168,17
2500,5691600,2040000,577282,610300,1187582,1700,28900,30600,2433418,168,17
2600,5928750,2182800,460832,629850,1090682,1700,30175,31875,2623393,168,17
2700,6165900,2221900,578302,402050,980352,1700,31450,33150,2930498,168,16
2800,6403050,2364700,462702,576300,1039002,1700,32725,34425,2964923,168,16
2900,6640200,2403800,578472,567800,1146272,1700,34000,35700,3054428,168,16
3000,6877350,2546600,461172,763300,1224472,1700,35275,36975,3069303,168,17
3100,7114500,2585700,24884,850,25734,592450,589033,1181483,3321583,168,17
3200,7351650,2585700,165559,0,165559,602650,675308,1277958,3322433,141,1
3300,7588800,2595050,319409,58650,378059,602650,689758,1292408,3323283,157,1
3400,7825950,2595050,307509,209100,516609,680000,692308,1372308,3341983,0,1
3500,8063100,2595050,361484,388450,749934,680000,693583,1373583,3344533,0,1
3600,8300250,2595050,333498,474300,807798,680000,694858,1374858,3522544,0,2
3700,8537400,2595050,379292,487050,866342,680000,696133,1376133,3699875,0,2
3800,8774550,2595050,353367,404600,757967,680000,697408,1377408,4044125,0,1
3900,9011700,2595050,406492,459850,866342,680000,698683,1378683,4171625,0,1
4000,9248850,2595050,379717,525300,905017,680000,699958,1379958,4368825,0,1
4100,9486000,2595050,431822,580550,1012372,680000,701233,1381233,4497345,0,2
4200,9723150,2595050,407172,484500,891672,680000,701233,1381233,4855195,0,1
4300,9960300,2595050,458831,540600,999431,680000,702933,1382933,4982886,0,2
4400,10197450,2595050,430526,606050,1036576,680000,704208,1384208,5181616,0,2
4500,10434600,2595050,480400,661300,1141700,680000,705483,1385483,5312367,0,4
4600,10671750,2595050,453795,396950,850745,680000,706758,1386758,5839197,0,2
4700,10908900,2595050,506580,446250,952830,680000,708033,1388033,5972987,0,2
4800,11146050,2595050,478275,511700,989975,680000,709308,1389308,6171717,0,2
4900,11383200,2595050,529360,566950,1096310,680000,710583,1390583,6301257,0,3
5000,11620350,2595050,497020,470900,967920,680000,710583,1390583,6666797,0,12
5100,11857500,2595050,537863,527000,1064863,680000,712283,1392283,6805304,0,14
5200,12094650,2595050,498126,592450,1090576,680000,713558,1393558,7015466,0,16
5300,12331800,2595050,538586,647700,1186286,680000,713558,1393558,7156906,0,17
5400,12568950,2595050,497871,552500,1050371,680000,715258,1395258,7528271,0,16
5500,12806100,2595050,537906,607750,1145656,680000,716533,1396533,7668861,0,16
5600,13043250,2595050,497701,673200,1170901,680000,717808,1397808,7879491,0,16
5700,13280400,2595050,528386,854250,1382636,680000,719083,1399083,7903631,0,18
5800,13517550,2595050,490306,632400,1122706,680000,719083,1399083,8400711,0,16
5900,13754700,2595050,528981,688500,1217481,680000,720783,1400783,8541386,0,16
6000,13991850,2595050,488776,753950,1242726,680000,722058,1402058,8752016,0,16
6100,14229000,2595050,2550,0,2550,1489200,1248744,2737944,8893456,0,17
6200,14466150,2595050,178500,2550,181050,1489200,1307394,2796594,8893456,215,0
6300,14703300,2632450,331500,40800,372300,1489200,1313344,2802544,8896006,169,0
6400,14940450,2772700,283475,184450,467925,1489200,1314619,2803819,8896006,169,0
6500,15177600,2814350,363800,240550,604350,1489200,1315894,2805094,8953806,168,0
6600,15414750,2954600,310654,389300,699954,1489200,1317169,2806369,8953827,168,1
6700,15651900,2996250,391043,266900,657943,1489200,1318444,2807644,9190063,168,1
6800,15889050,3136500,338768,251600,590368,1489200,1319719,2808919,9353263,168,0
6900,16126200,3178150,419093,289850,708943,1489200,1320994,2810194,9428913,168,0
7000,16363350,3318400,366563,438600,805163,1489200,1320994,2810194,9429593,168,1
7100,16600500,3360050,442723,476850,919573,1490050,1322694,2812744,9508133,168,2
7200,16837650,3500300,391298,286450,677748,1490050,1323969,2814019,9845583,168,0
7300,17074800,3541950,472473,268600,741073,1490050,1325244,2815294,9976483,168,0
7400,17311950,3682200,420198,396100,816298,1490050,1326519,2816569,9996883,168,0
7500,17549100,3723850,498972,434350,933322,1490050,1327794,2817844,10074084,168,2
7600,17786250,3864100,445422,419900,865322,1490050,1329069,2819119,10237709,168,1
7700,18023400,3905750,524217,458150,982367,1490050,1330344,2820394,10314889,168,2
7800,18260550,4046000,464207,606900,1071107,1490050,1331619,2821669,10321774,168,2
7900,18497700,4087650,543427,434350,977777,1490050,1332894,2822944,10609329,168,2
8000,18734850,4227900,483951,398650,882601,1490050,1334169,2824219,10800130,168,12
8100,18972000,4269550,552823,380800,933623,1490050,1335444,2825494,10943333,168,15
8200,19209150,4409800,486757,508300,995057,1490050,1336719,2826769,10977524,168,16
8300,19446300,4451450,553227,490450,1043677,1490050,1337994,2828044,11123129,168,17
8400,19683450,4591700,489052,454750,943802,1490050,1337994,2828044,11319904,168,16
8500,19920600,4633350,555097,436900,991997,1490900,1339694,2830594,11464659,168,16
8600,20157750,4773600,487947,585650,1073597,1490900,1340969,2831869,11478684,168,16
8700,20394900,4815250,553567,623900,1177467,1490900,1342244,2833144,11569039,168,17
8800,20632050,4955500,486927,609450,1096377,1490900,1343519,2834419,11745754,168,17
8900,20869200,4997150,551272,647700,1198972,1490900,1344794,2835694,11837384,168,17
9000,21106350,5137400,486247,620500,1106747,1490900,1344794,2835694,12026509,168,16
9100,21343500,5179050,238321,194650,432971,1899750,1659615,3559365,12172114,168,17
9200,21580650,5242800,203746,142800,346546,1990700,1800950,3791650,12199654,141,8
9300,21817800,5252150,352156,203150,555306,1990700,1815400,3806100,12204244,157,4
9400,22054950,5252150,333626,357000,690626,2068050,1817950,3886000,12226174,0,4
9500,22292100,5252150,388111,532950,921061,2068050,1819225,3887275,12231614,0,4
9600,22529250,5252150,354600,622200,976800,2068050,1819225,3887275,12413025,0,5
9700,22766400,5252150,399544,630700,1030244,2068050,1820925,3888975,12595031,0,5
9800,23003550,5252150,366989,552500,919489,2068050,1822200,3890250,12941661,0,4
9900,23240700,5252150,420624,602650,1023274,2068050,1823475,3891525,13073751,0,4
10000,23477850,5252150,387219,673200,1060419,2068050,1824750,3892800,13272481,0,4
