run_time       ,total_data     ,mutihop        ,sensor_data_origin,sensor_data_calc,sensor_data    ,uav_data_calc  ,uav_data_origin,uav_data       ,lost_data      ,connect_num    ,buffer_overflow_num
100,0,0,0,0,0,0,0,0,0,6,0
200,237150,0,199750,0,199750,0,37400,37400,0,195,0
300,474300,43350,340425,28900,369325,14450,47175,61625,0,195,0
400,711450,196350,264775,175950,440725,14450,59925,74375,0,195,0
500,948600,259250,343400,62050,405450,42500,85000,127500,156400,195,0
600,1185750,406300,279650,190400,470050,42500,110500,153000,156400,195,0
700,1422900,463250,349775,119850,469625,45050,137275,182325,307700,195,0
800,1660050,594150,316625,247350,563975,47600,146625,194225,307700,195,0
900,1897200,664700,392700,147050,539750,47600,148750,196350,496400,195,0
1000,2134350,803250,354450,281350,635800,47600,151300,198900,496400,195,0
1100,2371500,883150,409700,168300,578000,47600,163200,210800,699550,195,0
1200,2608650,1020850,372300,299200,671500,47600,166600,214200,702100,195,0
1300,2845800,1100750,418625,187000,605625,47600,188275,235875,903550,195,0
1400,3082950,1229100,366775,267750,634525,98600,214625,313225,906100,195,0
1500,3320100,1299650,436900,155550,592450,98600,221850,320450,1107550,195,0
1600,3557250,1431400,381225,284750,665975,98600,251175,349775,1110100,195,0
1700,3794400,1495150,459425,171700,631125,98600,255425,354025,1314100,195,0
1800,4031550,1626900,392700,262650,655350,140250,292400,432650,1316650,195,0
1900,4268700,1708500,437325,146200,583525,142800,320875,463675,1513000,195,0
2000,4505850,1839400,415779,263500,679279,142800,325125,467925,1519246,195,6
2100,4743000,1922700,469138,178500,647638,142800,327250,470050,1702612,195,7
2200,4980150,2052750,406854,300900,707754,142800,358084,500884,1718762,195,7
2300,5217300,2140300,425788,159800,585588,170000,401434,571434,1919978,195,7
2400,5454450,2266100,386454,266900,653354,170000,428868,598868,1936128,195,7
2500,5691600,2353650,441279,211650,652929,170000,431843,601843,2083178,195,6
2600,5928750,2483700,411529,328950,740479,170000,436093,606093,2098478,195,6
2700,6165900,2571250,458704,239700,698404,170000,438218,608218,2288028,195,6
2800,6403050,2702150,403879,301750,705629,224400,467543,691943,2303328,195,6
2900,6640200,2781200,419370,204000,623370,224400,510702,735102,2500528,195,6
3000,6877350,2897650,398545,321300,719845,224400,520477,744877,2514978,195,5
3100,7114500,2978400,14450,0,14450,445400,960672,1406072,2715578,195,5
3200,7351650,2980100,62050,850,62900,446250,1146822,1593072,2715578,151,0
3300,7588800,2984350,232050,19550,251600,446250,1191022,1637272,2715578,143,0
3400,7825950,3037050,321725,88400,410125,446250,1205047,1651297,2727478,203,0
3500,8063100,3037050,306000,216750,522750,548250,1214822,1763072,2740228,0,0
3600,8300250,3037050,340425,247350,587775,548250,1234797,1783047,2892378,0,0
3700,8537400,3037050,328908,454750,783658,548250,1244997,1793247,2923445,0,2
3800,8774550,3037050,360953,484500,845453,552500,1257747,1810247,3081800,0,2
3900,9011700,3037050,354897,671500,1026397,552500,1261147,1813647,3134606,0,3
4000,9248850,3037050,392042,419900,811942,552500,1261147,1813647,3586211,0,2
4100,9486000,3037050,377103,454750,831853,711450,1267161,1978611,3638486,0,2
4200,9723150,3037050,403984,261800,665784,797300,1278530,2075830,3944486,0,1
4300,9960300,3037050,385709,443700,829409,797300,1299355,2096655,3997186,0,1
4400,10197450,3037050,412059,328950,741009,797300,1322305,2119605,4299786,0,1
4500,10434600,3037050,402709,359550,762259,952000,1331655,2283655,4351636,0,1
4600,10671750,3037050,432884,382500,815384,952000,1349930,2301930,4517386,0,1
4700,10908900,3037050,409743,538900,948643,952000,1369480,2321480,4601727,0,2
4800,11146050,3037050,436093,392700,828793,952000,1389030,2341030,4939177,0,1
4900,11383200,3037050,413759,402050,815809,1002150,1413914,2416064,5114277,0,1
5000,11620350,3037050,450161,427550,877711,1008950,1420714,2429664,5275925,0,3
5100,11857500,3037050,433056,508300,941356,1011500,1428789,2440289,5438805,0,8
5200,12094650,3037050,460915,527850,988765,1011500,1438564,2450064,5618771,0,9
5300,12331800,3037050,445105,587350,1032455,1011500,1447064,2458564,5803731,0,10
5400,12568950,3037050,471880,433500,905380,1011500,1450039,2461539,6164981,0,9
5500,12806100,3037050,471179,469200,940379,1011500,1450039,2461539,6367132,0,10
5600,13043250,3037050,470605,414800,885405,1058250,1466423,2524673,6596122,0,10
5700,13280400,3037050,460681,403750,864431,1099050,1477197,2576247,6802672,0,9
5800,13517550,3037050,464081,427550,891631,1099050,1500147,2599197,6989672,0,9
5900,13754700,3037050,460681,472600,933281,1099050,1509497,2608547,7175822,0,9
6000,13991850,3037050,466631,504900,971531,1099050,1531597,2630647,7352622,0,9
6100,14229000,3037050,1700,0,1700,1656650,1997378,3654028,7536222,0,9
6200,14466150,3038750,135575,0,135575,1656650,2098953,3755603,7536222,320,0
6300,14703300,3083800,267325,17000,284325,1656650,2142303,3798953,7536222,209,0
6400,14940450,3229150,266900,90100,357000,1656650,2161428,3818078,7536222,200,0
6500,15177600,3291200,338300,107100,445400,1658350,2176728,3835078,7605922,195,0
6600,15414750,3423800,308125,205700,513825,1658350,2180553,3838903,7638222,195,0
6700,15651900,3500300,376550,170000,546550,1658350,2182678,3841028,7764022,195,0
6800,15889050,3642250,336175,224400,560575,1658350,2185653,3844003,7842222,195,0
6900,16126200,3717900,403750,189550,593300,1658350,2187778,3846128,7968872,195,0
7000,16363350,3859850,347650,243950,591600,1658350,2206478,3864828,8047072,195,0
7100,16600500,3930400,393975,172550,566525,1694900,2234103,3929003,8174572,195,0
7200,16837650,4051950,359125,151300,510425,1766300,2256203,4022503,8252772,195,0
7300,17074800,4131850,413100,186150,599250,1766300,2268528,4034828,8308872,195,0
7400,17311950,4255100,378250,191250,569500,1766300,2294878,4061178,8426172,195,0
7500,17549100,4338400,424575,235450,660025,1766300,2310603,4076903,8473772,195,0
7600,17786250,4454000,394825,216750,611575,1766300,2335253,4101553,8619122,195,0
7700,18023400,4539850,439875,252450,692325,1766300,2350553,4116853,8674372,195,0
7800,18260550,4660550,405025,231200,636225,1766300,2381153,4147453,8816322,195,0
7900,18497700,4737900,468775,271150,739925,1766300,2381153,4147453,8872422,195,0
8000,18734850,4862000,444870,260100,704970,1766300,2384978,4151278,9016602,195,5
8100,18972000,4955500,468479,300050,768529,1766300,2404103,4170403,9077568,195,6
8200,19209150,5079600,449397,276250,725647,1766300,2404103,4170403,9233500,195,8
8300,19446300,5173950,460022,272850,732872,1812200,2430878,4243078,9296400,195,8
8400,19683450,5292100,441981,249050,691031,1812200,2436403,4248603,9451716,195,9
8500,19920600,5375400,476406,245650,722056,1856400,2450428,4306828,9516316,195,9
8600,20157750,5504600,431781,213350,645131,1856400,2477203,4333603,9674416,195,9
8700,20394900,5582800,463231,195500,658731,1927800,2501003,4428803,9724566,195,9
8800,20632050,5700950,439006,244800,683806,1927800,2508228,4436028,9811266,195,9
8900,20869200,5790200,456006,249050,705056,1927800,2541378,4469178,9904766,195,9
9000,21106350,5904950,433906,298350,732256,1927800,2549878,4477678,9991466,195,9
9100,21343500,5991650,18934,0,18934,2194700,3019250,5213950,10118966,195,9
9200,21580650,5993350,74609,850,75459,2195550,3196475,5392025,10119816,151,1
9300,21817800,5998450,252684,21250,273934,2195550,3229200,5424750,10120666,143,1
9400,22054950,6062200,334284,92650,426934,2195550,3234300,5429850,10135966,203,1
9500,22292100,6062200,318559,341700,660259,2195550,3236425,5431975,10137666,0,1
9600,22529250,6062200,360634,176800,537434,2356200,3238019,5594219,10335397,0,2
9700,22766400,6062200,330459,428400,758859,2356200,3252044,5608244,10337097,0,1
9800,23003550,6062200,377209,275400,652609,2481150,3263094,5744244,10544497,0,1
9900,23240700,6062200,346609,464950,811559,2481150,3284344,5765494,10601447,0,1
10000,23477850,6062200,392934,438600,831534,2481150,3294119,5775269,10808847,0,1
